########                      ########
#                                    #
#                                    #
#                                    #
#                                    #
#                                    #
#                # #                 #
#               ## ##                #
               ### ###                
              #### ####               
             ##### #####              
            ###### ######             
     X                                
            ###### ######             
             ##### #####              
              #### ####               
               ### ###                
                ## ##                 
#                # #                 #
#                                    #
#                                    #
#                                    #
#                                    #
#                                    #
#                                    #
########                      ########
